##################################################################################################
#
#                                                                                                D
#                                                                                 #
#                                                                                 ###E###E###E####
#                                                                                   # # # # # #  #
#                                                                                   ### ### ###  #
#                                                                  #                             #
#                                                                                                #
#                                                                                                #
#                                                                                                #
#                                                  #                                             #
#                                                                                                #
#                                                                                                #
#                                                                                                #
#                                    #                                                           #
#                                                                                                #
#                                                                                                #
#                                                                                                #
#                    #                                                                           #
#                                                                                                #
#          #                                                                                     #
# @                                                                                              #
#                                                                                                #
##################################################################################################