##############################################################################################
#                                              ###############################################
#                                              ###############################################
#                                 ####         ###############################################
#                                 ####         ###############################################
#                                 ####                 #######################################
#   @                             ####                 #######################################
#                                E####                 #######################################
#                  #############  ##################   #######################################
#                  #################################   #######################################
#                  #################################   #######################################
#                  #################################   #######################################
#                  #################################                                 #########
#                  #################################
#                  #################################                                        D
#                  #################################
#        ###########################################                                 #########
#        ###############################################   E       ### E   E   E   E #########
#        ###############################################           ###               #########
##############################################################################################