#################################################################
#                              #
#                             #######                          D
# S                            #
########                        #                              ##
#                                                               #
#             #                                                 #
#                                                               #
#                                                               #
#                                         #                     #
#                                                               #
#                                                               #
#                                                               #
#                                                               #
#                                                      #        #
#                                                               #
#                                                  #            #
#                                                               #
#                                                               #
#                                               #               #
#                                                               #
#                                                               #
#                                                    #          #
#                                                               #
#                                                               #
#                                                #              #
#                                                               #
#                                    #                          #
#                              #                                #
#                                                               #
#               ##########                                      #
#               ##########                                      #
#         ################                                      #
#                                                               #
#  @                                                            #
#################################################################